Michael English - Mary, Did You Know?
Destiny's Child - 8 Days of Christmas
Bing Crosby - White Christmas
Margaret Whiting - Baby, It's Cold Outside
Sia - Snowman
Zangeres Zonder Naam - Vrolijk Kerstfeest
Pentatonix - That's Christmas to Me
Jona Lewie - Stop the Cavalry - Remastered
BZN - This Is Christmas Night
Charly Lownoise & Mental Theo - This Christmas - Radio Version
Fay Lovsky - Christmas Was a Friend of Mine
*NSYNC - Merry Christmas, Happy Holidays
Vader Abraham - Ring, Ring, Ring
Kelly Clarkson - Santa, Can’t You Hear Me
Ariana Grande - Santa Tell Me
Billie Eilish - come out and play
Boney M. - Mary's Boy Child / Oh My Lord
Arthur Baker And The Backbeat Disciples - The Message Is Love
Melanie Thornton - Wonderful Dream (Holidays Are Coming) - Radio Version
Cliff Richard - Mistletoe and Wine
Kelly Clarkson - Underneath the Tree
Corry en de Rekels - Hoog Daar Aan De Hemel
Rob De Nijs - Natte Kerst - Bonus Track
Taylor Swift - Christmas Tree Farm
The Jackson 5 - Santa Claus Is Coming To Town
Vaughn Monroe - Let It Snow! Let It Snow! Let It Snow!
Duncan Laurence - Wishes Come True
Jonas Brothers - Like It's Christmas
José Feliciano - Feliz Navidad
Benny Neyman - Kerstdagen Van Toen
André Hazes Jr. - Deze Kerst Ben Ik Bij Jou
Alan Jackson - Honky Tonk Christmas
Emma Heesters - Als De Eerste Sneeuw Valt
Harry Simeone Chorale - The Little Drummer Boy - 1965 Version
Michael Bublé - The More You Give (The More You'll Have)
Queen - Thank God It's Christmas
Nick & Simon - Best Time of the Year
Corry Konings - Een Kaartje Met Kerstmis
Johnny Mathis - We Need a Little Christmas
OneRepublic - Dear Santa
Cyndi Lauper - Early Christmas Morning
Bryan Adams - Christmas Time
The Beach Boys - God Only Knows
Band Aid - Do They Know It's Christmas? - 1984 Version
Henk Temming - Ik Vraag Aan Sinterklaas Een Heel Gelukkig Kerstfeest
Youp van 't Hek - Flappie
Jimmy Boyd - I Saw Mommy Kissing Santa Claus
Céline Dion - The Prayer
Brenda Lee - Rockin' Around the Christmas Tree - Remastered
Bing Crosby - I'll Be Home For Christmas
Charles Brown - Please Come Home For Christmas
Frank Sinatra - Jingle Bells
The Pogues - Fairytale of New York (feat. Kirsty MacColl)
Céline Dion - I Met an Angel (on Christmas Day)
Burl Ives - A Holly Jolly Christmas
Slade - Merry Xmas Everybody
OG3NE - The Power of Christmas
Nielson - Kerstcadeau
Gloria Estefan - Christmas Through Your Eyes
Kinderen voor Kinderen - De Kerstezel
Do - Everyday Is Christmas
John Lennon - Happy Xmas (War Is Over) - Remastered 2010
Pretenders - 2000 Miles
Guus Meeuwis - Hoe Dan Ook
Felice Taylor - It May Be Winter Outside (But in My Heart It's Spring)
Stevie Wonder - Someday At Christmas
New Kids On The Block - This One's for the Children
Los Del Rio - Macarena Christmas - Joy Mix
Wham! - Last Christmas
Guillermo - Kerstvakantie
Barry Manilow - Christmas Is Just Around The Corner (From "Cranberry Christmas")
Andy Williams - It's the Most Wonderful Time of the Year
Milow - Christmas Is Finally Here
Mariah Carey - All I Want for Christmas Is You
Hilary Duff - Santa Claus Lane
Coldplay - Christmas Lights
Andre Hazes - Eenzame Kerst
Jan Smit - Kerst Voor Iedereen
Leona Lewis - One More Sleep
East 17 - Stay Another Day
The Common Linnets - Christmas Around Me
Donny Hathaway - This Christmas
Whitney Houston - One Wish (For Christmas)
Queen - A Winter's Tale - 2011 Remaster
Heintje - Morgen wordt de boom versierd
Sesamstraat - Ik ben een kerstbal
Koos Alberts - Waarom ben ik met Kerstmis zo alleen
Gene Autry - Frosty the Snowman (with The Cass County Boys) - 78rpm Version
Jannes - Deze Kerst Ben Je Bij Mij
Buck Owens - Santa Looked A Lot Like Daddy (Daddy Looked A Lot Like Him)
Georgina Verbaan - This Christmas
Ed Sheeran - Merry Christmas
Nat King Cole Trio - The Christmas Song (Merry Christmas To You)
CeeLo Green - All I Need Is Love (feat. Disney's the Muppets)
Meghan Trainor - I'll Be Home
Little Mix - One I've Been Missing
Train - Shake Up Christmas
Toni Braxton - Christmas In Jamaica (feat. Shaggy)
The Partridge Family - My Christmas Card to You
Snollebollekes - Beuk De Ballen Uit De Boom
Elton John - Step Into Christmas - Remastered
The Darkness - Christmas Time (Don't Let the Bells End)
Ava Max - Christmas Without You
Miss Montreal - Being Alone At Christmas
J.Bon Jovi - I Wish Everyday Could Be Like Christmas
Andre Hazes - Met Kerst Ben Ik Alleen
Britney Spears - My Only Wish (This Year)
Nick & Simon - Santa's Party
Darlene Love - All Alone on Christmas
Gene Autry - Here Comes Santa Claus (Right Down Santa Claus Lane) - 1947 Version
The Beatles - All You Need Is Love
The Ronettes - Sleigh Ride
Katy Perry - Cozy Little Christmas
Mud - Lonely This Christmas
Kinderen voor Kinderen - Niets is Cooler dan Kerstmis
Darlene Love - Christmas (Baby Please Come Home)
Colbie Caillat - Mistletoe
Manke Nelis - Het Mooiste Kerstfeest
Run–D.M.C. - Christmas In Hollis
Chris Rea - Driving Home for Christmas - 2019 Remaster
RuPaul - Christmas Nite - Remastered
Dolly Parton - Hard Candy Christmas
Chris de Burgh - A Spaceman Came Travelling
Heidi Klum - Wonderland
Kenny Chesney - All I Want for Christmas Is a Real Good Tan
Ome Henk - Het Is Weer Kerstfeest Dit Jaar
Perry Como - It's Beginning to Look a Lot Like Christmas (with Mitchell Ayres & His Orchestra)
Elvis Presley - Blue Christmas
Kylie Minogue - Every Day's Like Christmas
Dana - It's Gonna Be a Cold, Cold Christmas
Faith Hill - Where Are You Christmas - From "Dr. Seuss' How The Grinch Stole Christmas" Soundtrack
Eartha Kitt - Santa Baby (with Henri René & His Orchestra)
Gerard Joling - Christmas on the Dance Floor
Johnny Jordaan - Kerstmis In De Jordaan - Remastered 2022
Chuck Berry - Run Rudolph Run
Jaap Reesema - Maar 1 Wens Met Kerstmis
Amy Grant - Grown-Up Christmas List
Paul McCartney - Wonderful Christmastime - Remastered
Frans Bauer - Papa, Met Kerst Ben Ik Bij Je
Gwen Stefani - You Make It Feel Like Christmas (feat. Blake Shelton)
Sabrina Carpenter - A Nonsense Christmas
Tony Bennett - Winter Wonderland
Krezip - Where The Light Goes
Shawn Phillips - A Christmas Song
Wizzard - I Wish It Could Be Christmas Everyday
De Jeugd Van Tegenwoordig - Ho Ho Ho
The Waitresses - Christmas Wrapping
Judy Garland - Have Yourself A Merry Little Christmas
Stevie Wonder - What Christmas Means To Me
Bobby Helms - Jingle Bell Rock
Shakin' Stevens - Merry Christmas Everyone
David Essex - A Winter's Tale
Bianca Ryan - Why Couldn't It Be Christmas Everyday?
Justin Bieber - Mistletoe