Barry White - You're The First, The Last, My Everything
Cyndi Lauper - True Colors
Meat Loaf - Paradise By the Dashboard Light
Peter Koelewijn en Zijn Rockets - Kom van dat dak af
Nielson - Sexy Als Ik Dans
Taio Cruz - Hangover
One More Time - Radio Edit [Short Radio Edit]
Gipsy Kings - Volare (Nel Blu di Pinto di Blu)
Kaoma - Lambada - Version 1989
Bob Marley & The Wailers - No Woman No Cry
Erma Franklin - Piece of My Heart
Guns N' Roses - Sweet Child O' Mine
Eurythmics - Sweet Dreams (Are Made of This) - 2005 Remaster
Doe Maar - 1 Nacht Alleen
Sinéad O'Connor - Nothing Compares 2 U
Beyoncé - Crazy In Love (feat. JAY-Z)
Rick James - Super Freak
De Dijk - Mag Het Licht Uit
Sia - Cheap Thrills
The Platters - Smoke Gets In Your Eyes
Lukas Graham - 7 Years
Lorde - Royals
Jacques Brel - Marieke
Laura Jansen - Wicked World
2 Unlimited - No Limit
The Cranberries - Zombie
Alessia Cara - Scars To Your Beautiful
Rupert Holmes - Escape (The Pina Colada Song)
Enya - Orinoco Flow
ABBA - Waterloo
Bob Sinclar - World Hold on (Children of the Sky) [Radio Edit]
James Brown & The Famous Flames - I Got You (I Feel Good)
Normaal - Oerend Hard
Billy Joel - Piano Man
The Beatles - Get Back - Remastered 2009
Plastic Bertrand - Ca plane pour moi
Lionel Richie - Dancing On The Ceiling
Patrick Hernandez - Born to Be Alive - The Original
Herman Brood - Als Je Wint
Mabel - Don't Call Me Up
Nirvana - Smells Like Teen Spirit
The Bangles - Manic Monday
Amii Stewart - Knock On Wood
Aqua - Barbie Girl
Nancy Sinatra - These Boots Are Made For Walkin'
Nelly - Dilemma (feat. Kelly Rowland)
Mungo Jerry - In the Summertime
Eros Ramazzotti - Più bella cosa
Herman van Veen - Anne
50 Cent - In Da Club
Joseito Fernández - Guajira Guantanamera
Lady Gaga - Shallow - Radio Edit
Mark Ronson - Valerie (feat. Amy Winehouse) - Baby J Remix Ft Rukus, Precha, Alex Blood and Malik
Creedence Clearwater Revival - Have You Ever Seen The Rain
The Supremes - You Can't Hurry Love
Nickelback - How You Remind Me
Ace of Base - All That She Wants
Jessie J - Price Tag
The Offspring - Self Esteem
Loreen - Euphoria
Donovan - Atlantis
Four Tops - I Can't Help Myself (Sugar Pie, Honey Bunch)
Boston - More Than a Feeling
The Four Seasons - December, 1963 (Oh What a Night!)
Icona Pop - I Love It (feat. Charli XCX)
Amy Macdonald - This Is The Life
Chumbawamba - Tubthumping - Radio Edit
Neneh Cherry - Buffalo Stance
Fluitsma & van Tijn - 15 Miljoen Mensen
Commodores - Easy
Ilse DeLange - So Incredible
Lady Gaga - Poker Face
The Trammps - Disco Inferno
Ritchie Valens - La Bamba - Single Version
The Human League - Don't You Want Me
Enrico Caruso - Rigoletto: "La Donna E' Mobile"
Imagine Dragons - Thunder
Richard Marx - Right Here Waiting
Leo Sayer - When I Need You
Linda Ronstadt - Blue Bayou
The Archies - Sugar, Sugar
Sophie Ellis-Bextor - Murder On The Dancefloor
Glenn Miller - In the Mood - 2006 Remastered Version
Rufus - Ain't Nobody
Major Lazer - Lean On (feat. MØ & DJ Snake)
Outkast - Hey Ya!
Corona - The Rhythm of the Night
P!nk - Just Give Me a Reason (feat. Nate Ruess)
Pearl Jam - Alive
Bill Haley & His Comets - (We're Gonna) Rock Around The Clock
Bloem - Even Aan Mijn Moeder Vragen
Rene Froger - Alles Kan Een Mens Gelukkig Maken
Hans De Booij - Annabel
Cuby & The Blizzards - Window Of My Eyes - From "The American" Soundtrack
Eddy Grant - Gimme Hope Jo'Anna
Moby - Porcelain
Stef Bos - Papa
Pharrell Williams - Happy - From "Despicable Me 2"
Paul Elstak - Rainbow In The Sky - Radio Edit
Tom Jones - Green Green Grass Of Home
Kanye West - Gold Digger
Daryl Hall & John Oates - Maneater
Shaggy - It Wasn't Me
Tracy Chapman - Fast Car
Bill Haley & His Comets - See You Later, Alligator
Thelma Houston - Don't Leave Me This Way
Wet Wet Wet - Love Is All Around - From "Four Weddings And A Funeral"
Lynyrd Skynyrd - Sweet Home Alabama
Limahl - Never Ending Story
Harry Belafonte - Day-O (The Banana Boat Song)
The Beach Boys - Surfin' U.S.A. (Mono)
Dua Lipa - Break My Heart
Robin Thicke - Blurred Lines
Elvis Presley - Jailhouse Rock
Billie Eilish - bad guy
Teddy Scholten - Een Beetje
Las Ketchup - The Ketchup Song (Aserejé) - Spanglish Version
Alicia Keys - No One
Armand - Ben Ik Te Min
Betty Everett - It's In The Kiss (The Shoop Shoop Song)
Miley Cyrus - Wrecking Ball
Corinne Bailey Rae - Put Your Records On
Cliff Richard - Congratulations - 1998 Remaster
Jason Derulo - Whatcha Say
Chubby Checker - The Twist
Laura Branigan - Self Control
BLØF - Wat Zou Je Doen?
Steppenwolf - Born To Be Wild
The Verve - Bitter Sweet Symphony - Remastered 2016
Crowded House - Don't Dream It's Over
Journey - Don't Stop Believin'
Andre Hazes - Bloed, Zweet En Tranen
Def Rhymz - Doekoe
Rick Astley - Never Gonna Give You Up
Vaya Con Dios - Nah Neh Nah
TLC - Waterfalls
Kool & The Gang - Celebration
Snelle - Smoorverliefd
Bill Medley - (I've Had) The Time of My Life - From "Dirty Dancing" Soundtrack
TOTO - Africa
Natalie Imbruglia - Torn
Céline Dion - My Heart Will Go On - Love Theme from "Titanic"
Mark Morrison - Return of the Mack
Karel Van De Velden - Kijk Eens In De Poppetjes Van Mijn Ogen
Eagle-Eye Cherry - Save Tonight
Little Eva - The Locomotion
Chuck Berry - Johnny B. Goode
Drake - Toosie Slide
Justin Bieber - Anyone
Gotye - Somebody That I Used to Know
OneRepublic - Counting Stars
Fatboy Slim - Praise You
Jennifer Lopez - If You Had My Love
Billy Swan - I Can Help
Wim Sonneveld - Het Dorp
Lewis Capaldi - Someone You Loved
Technohead - I Wanna be a Hippy
George Michael - I Knew You Were Waiting (For Me)
Stevie Wonder - Signed, Sealed, Delivered (I'm Yours)
Marvin Gaye - I Heard It Through The Grapevine
David Bowie - Life On Mars'
Chicago - If You Leave Me Now
Bruce Springsteen - Dancing In the Dark
The Rolling Stones - Start Me Up - Remastered 2009
Dire Straits - Walk Of Life
Sam The Sham & The Pharaohs - Wooly Bully
Enrique Iglesias - Do You Know? (The Ping Pong Song)
Whitney Houston - I Wanna Dance with Somebody (Who Loves Me)
Haddaway - What Is Love - 7" Mix
Shakira - Waka Waka (This Time for Africa) [The Official 2010 FIFA World Cup (TM) Song] (feat. Freshlyground)
MIKA - Relax, Take It Easy
Fleetwood Mac - Everywhere - 2017 Remaster
The Arrows - I Love Rock N Roll
Madonna - 4 Minutes (feat. Justin Timberlake & Timbaland)
The Osmonds - Crazy Horses
The Kinks - Lola
Suzan & Freek - Als Het Avond Is
Linda Roos & Jessica - Ademnood
USHER - Yeah! (feat. Lil Jon & Ludacris)
Douwe Bob - Slow Down
Bruno Mars - The Lazy Song
Coolio - Gangsta's Paradise
Kelly Clarkson - Because of You
Maroon 5 - Moves Like Jagger - Studio Recording From "The Voice" Performance
T'Pau - China In Your Hand
Roxette - The Look
Robbie Williams - Feel
Spice Girls - Stop
Neil Diamond - Girl, You'll Be A Woman Soon
Johnny Cash - Ring of Fire
Genesis - No Son Of Mine
Simple Minds - Belfast Child - Remastered 2002
Adele - Set Fire to the Rain
Niels Geusebroek - Take Your Time Girl (live at ruud de wild/538)
Alicia Keys - Fallin'
Duck Sauce - Barbra Streisand (Radio Edit)
Anouk - Michel
John Legend - All of Me
Queen - Under Pressure - Remastered 2011
The Chordettes - Lollipop
Culture Beat - Mr. Vain
Yazoo - Don't Go
André Hazes Jr. - Leef
Paul Simon - You Can Call Me Al
Bronski Beat - Smalltown Boy
Meghan Trainor - All About That Bass
Dion - The Wanderer
Van Dik Hout - Stil In Mij
Oasis - Wonderwall
Dorus - Twee Motten
Snow - Informer
Vanilla Ice - Ice Ice Baby
De Kast - In Nije Dei
O-Zone - Dragostea Din Tei
Stereophonics - Have A Nice Day
Simply Red - Holding Back the Years - 2008 Remaster
Tears For Fears - Shout
Rednex - Cotton Eye Joe
Reel 2 Real - I Like To Move It (feat. The Mad Stuntman) - Erick "More" Album Mix
Dolly Parton - Jolene
Bryan Adams - Heaven
Jan Smit - Als De Morgen Is Gekomen
Jan & Dean - Surf City (Rerecorded)
Red Hot Chili Peppers - Under the Bridge
Lenny Kravitz - Fly Away
Prince - Purple Rain
Rob De Nijs - Ritme Van De Regen
The Monkees - I'm a Believer - 2006 Remaster
Gers Pardoel - Ik Neem Je Mee
Elvis Presley - Can't Help Falling in Love
R.E.M. - Everybody Hurts
Rowwen Hèze - De Peel In Brand
Earth & Fire - Weekend
Will Smith - Gettin' Jiggy Wit It
CHIC - Le Freak - 2018 Remaster
Caro Emerald - A Night Like This
Sylvester - You Make Me Feel (Mighty Real)
Jimmy Cliff - You Can Get It If You Really Want
Captain Jack - Captain Jack - Short Mix
Corry Brokken - La Mamma (Zij Kwamen Overal Vandaan)
Tina Turner - The Best
John Mayer - Daughters
Anita Meyer - Why Tell Me Why
Bon Jovi - It's My Life
Black & White - Daar Bij De Waterkant
Guus Meeuwis - Brabant
Tones And I - Dance Monkey
Sam Cooke - (What A) Wonderful World - Mono
No Doubt - Don't Speak
The Waterboys - The Whole of the Moon - 2004 Remaster
Christina Aguilera - Genie In a Bottle
The Police - Every Breath You Take
Olivia Rodrigo - drivers license
Shawn Mendes - Señorita
Conny Vandenbos - Ik Ben Gelukkig Zonder Jou
Dr. Alban - Sing Hallelujah!
Avicii - Without You (feat. Sandro Cavazza)
Diana Ross - Upside Down
Eric Prydz - Call on Me - Radio Mix
The Everly Brothers - All I Have to Do Is Dream
Fats Domino - Ain't That A Shame
Annie Lennox - Why
Faithless - God Is a DJ
Britney Spears - Oops!...I Did It Again
KC & The Sunshine Band - Give It Up
Black Eyed Peas - Where Is The Love?
Modjo - Lady - Hear Me Tonight
Harry Styles - Adore You
Roy Orbison - Oh, Pretty Woman
Sonny & Cher - I Got You Babe
Akon - Lonely
Sister Sledge - We Are Family - 1995 Remaster
Elton John - Your Song
Aretha Franklin - Respect
Bryan Ferry - Let's Stick Together
Carly Simon - You're So Vain
MadHouse - Like a Prayer
Dean Martin - That's Amore
Les Poppys - Non non rien n'a changé
Gerard Cox - 1948 (Toen Was Geluk Heel Gewoon)
Zen - Hair
Ed Sheeran - Bad Habits
Twenty One Pilots - Stressed Out
Neil Diamond - Sweet Caroline
Train - Hey, Soul Sister
Van McCoy - The Hustle
Amy Winehouse - Rehab
Clouseau - Daar Gaat Ze
Boney M. - Daddy Cool
The Weeknd - Blinding Lights
Alvaro Soler - La Cintura
Davina Michelle - Duurt Te Lang
Duffy - Mercy
Katy Perry - Firework
Anneke Gronloh - Brandend Zand
JAY-Z - Numb / Encore
Joe Cocker - With A Little Help From My Friends
George Baker - Una Paloma Blanca
De Poema's - Mijn Houten Hart
Ramses Shaffy - Laat Me
Portugal. The Man - Feel It Still
Boudewijn de Groot - Een Meisje Van Zestien
The Champs - Tequila
Golden Earring - Radar Love - Original Single Edit 1973
The Cats - Sure He's A Cat
The Beatles - Let It Be - Remastered 2009
Percy Sledge - When a Man Loves a Woman - Mono
Owl City - Fireflies
