The Pointer Sisters - I'm So Excited
Right Said Fred - I'm Too Sexy
Run–D.M.C. - Walk This Way (feat. Aerosmith)
Shocking Blue - Venus
J Balvin - Mi Gente - Original Mix
Taylor Swift - Shake It Off
Gwen Stefani - What You Waiting For?
Mo-Do - Eins Zwei Polizei - Radio Edit
Doop - Doop - dooper than doop
Het Goede Doel - Belgie ... (Is Er Leven Op Pluto ...)
Cerrone - Supernature - Edit
2 Unlimited - No Limit
The B-52's - Love Shack - Edit
Technotronic - Pump Up The Jam - Edit
2 Brothers On The 4th Floor - Come Take My Hand
Alex Gaudino - Destination Calabria (Feat. Crystal Waters) - Original Radio Edit
Piet Veerman - Sailin' Home
House Of Pain - Jump Around
Lil Nas X - Old Town Road - Remix
Dusty Springfield - Son Of A Preacher Man
Panic! At The Disco - High Hopes
DNCE - Cake By The Ocean
Les Poppys - Non non rien n'a changé
Baauer - Harlem Shake
Hanson - MMMBop
Britney Spears - ...Baby One More Time
John De Bever - Jij Krijgt Die Lach Niet Van Mijn Gezicht
The Bangles - Walk Like an Egyptian
Shakira - Hips Don't Lie (feat. Wyclef Jean)
Survivor - Eye of the Tiger
Fake Blood - I Think I Like It
Dennie Christian - Rosamunde
Starship - We Built This City
B.B. Band - Stille Willie
Sister Sledge - He's the Greatest Dancer - 1995 Remaster
Manke Nelis - Kleine Jodeljongen
George Michael - Too Funky - Single Edit
Trafassi - Wasmasjien
Deee-Lite - Groove Is in the Heart
BTS - Dynamite
The Cardigans - Lovefool
Robin S - Show Me Love
Europe - The Final Countdown
Christina Aguilera - Lady Marmalade - From "Moulin Rouge" Soundtrack
KC & The Sunshine Band - That's the Way (I Like It) - 2004 Remaster
MIKA - Big Girl (You Are Beautiful)
Hepie & Hepie - Ik lig op mijn kussen stil te dromen
A Touch Of Class - Around the World (La La La La La) - Radio Version
Inner Circle - Sweat (A La La La La Long)
Gerard Joling - Maak Me Gek
Elvis Presley - It's Now or Never
Opgeblazen - De Toreador
Gers Pardoel - Bagagedrager
Wham! - Club Tropicana
BZN - Mon Amour
Gnarls Barkley - Crazy
Boyzone - Picture Of You
Major Lazer - Watch out for This (Bumaye) [feat. Busy Signal, the Flexican & Fs Green]
Ricky Martin - Livin' la Vida Loca
Kraantje Pappie - Feesttent
The Knack - My Sharona
Liesbeth List - Kinderen Een Kwartje
Murray Head - One Night In Bangkok - Radio Edit / From “Chess” / Remastered 2016
Billy Joel - Uptown Girl
Jayh - Mooie Dag
Don Lore V - Danza Kuduro - Original Mix
Kylie Minogue - Can't Get You out of My Head
Urban Cookie Collective - The Key, The Secret
Alcazar - Crying at the Discoteque - Radio Edit
a-ha - Take on Me
Lawineboys - Sex Met Die Kale
Zanger Rinus - Met Romana op de scooter
Madonna - Like a Virgin
Bob Dylan - Mr. Tambourine Man
Salt-N-Pepa - Push It
Cliff Richard & The Shadows - Living Doll
Daddy Yankee - Con Calma
Peter De Koning - Het Is Altijd Lente in De Ogen Van De Tandartsassistente
Rockwell - Somebody's Watching Me
Katrina & The Waves - Walking On Sunshine
Herman van Veen - Opzij
September - Cry for You - UK Radio Edit
Ben E. King - Stand By Me
Double Trouble - Street Tuff
Polo & Pan - Mexicali
Lady Gaga - Just Dance
Robbie Williams - Angels
Stef Ekkel - Liever Te Dik In De Kist
Rob De Nijs - Banger Hart
The Ronettes - Be My Baby
Jan Hammer - Crockett's Theme
Carl Douglas - Kung Fu Fighting
Paco - Amor de Mis Amores - La Foule - France No. 1 Version
Gloria Gaynor - I Will Survive - Single Version
Meat Loaf - I'd Do Anything For Love (But I Won't Do That) - Single Edit
Jody Bernal - Que Si, Que No - Sunclub Radio Mix
Party Animals - Have You Ever Been Mellow
Eva Simons - Policeman
Backstreet Boys - I Want It That Way
Stevie Wonder - Sir Duke
David Guetta - When Love Takes Over (feat. Kelly Rowland)
Fine Young Cannibals - She Drives Me Crazy
De Jeugd Van Tegenwoordig - Watskeburt?!
Seal - Kiss from a Rose
Petula Clark - Downtown
Jermaine Jackson - When the Rain Begins to Fall
Eiffel 65 - Blue (Da Ba Dee) - Gabry Ponte Ice Pop Radio
Doe Maar - De Bom
C & C Music Factory - Gonna Make You Sweat (Everybody Dance Now) (feat. Freedom Williams)
The Mamas & The Papas - California Dreamin'
Stealers Wheel - Stuck In The Middle With You
Rain Radio - Talk About
PIKOTARO - PPAP(Pen-Pineapple-Apple-Pen)
The Righteous Brothers - Unchained Melody
Harry Styles - Watermelon Sugar
Sonny & Cher - The Beat Goes On
Fedde Le Grand - Put Your Hands Up For Detroit - Radio Edit
Justin Bieber - Baby
Boney M. - Ma Baker
Redbone - We Were All Wounded at Wounded Knee
Snollebollekes - Links Rechts
Yolanda Be Cool - We No Speak Americano
Earth, Wind & Fire - September
WTF! - Da Bop - Dutch Radio Edit
The Zombies - Time of the Season - Mono Version
Zouk Machine - Maldòn - Version originale
Brainpower - Dansplaat
Madness - One Step Beyond - 2009 - Remaster
Gebroeders Ko - Ik Heb Een Toeter Op M'n Waterscooter
Shanice - I Love Your Smile
Bros - When Will I Be Famous?
Scissor Sisters - I Don't Feel Like Dancin' - Radio Edit
Guillermo - Toppertje! - Original Mix
Willeke Alberti - Ome Jan
Deep Blue Something - Breakfast At Tiffany's
Cher - Believe
Heart - Alone
Joe Stagiair van de Show - Ja Jij
Los Del Rio - Macarena
Bobby McFerrin - Don't Worry Be Happy
P!nk - Get the Party Started
Benny Benassi - Satisfaction - Original Mix
Lil' Kim - How Many Licks? (feat. Sisqo)
Ray Charles - Hit the Road Jack
Atomic Kitten - Whole Again
Michel Delpech - Pour un flirt
Simon & Garfunkel - The Sound of Silence
Trobi - Einstein
Antoon - Hallo
DJ Snake - Turn Down for What
Luis Fonsi - Despacito
Lorna - Papi Chulo... Te Traigo El Mmmm - Radio Version
Daddy Yankee - Gasolina
Nena - 99 Luftballons
Bonnie Tyler - Total Eclipse of the Heart
Jason Derulo - Take You Dancing
Darude - Sandstorm
Sir Mix-A-Lot - Baby Got Back
Diana Ross - I'm Coming Out
John Travolta - Summer Nights - From “Grease”
Dolly Parton - 9 to 5
Duran Duran - The Wild Boys
INXS - Suicide Blonde
The Proclaimers - I'm Gonna Be (500 Miles) - 2011 Remaster
Prince - Cream - Without Rap Monologue
Vader Abraham - 't Kleine Café Aan De Haven
David Guetta - Who's That Chick? (feat. Rihanna)
2 Brothers On The 4th Floor - Never Alone
Sash! - Ecuador - Original Radio Edit
Helene Fischer - Atemlos durch die Nacht
Bruno Mars - Just the Way You Are
SNAP! - Rhythm Is A Dancer - 7" Edit
Harry Klorkestein - O O Den Haag
Britt - F*cking Vet!!!
The Human League - Don't You Want Me
Odyssey - Use It Up and Wear It Out - Radio Version
Lilly Wood and The Prick - You Want My Money
Wolter Kroes - Ik Heb De Hele Nacht Liggen Dromen - Single Versie
The Pussycat Dolls - Don't Cha
Ed Sheeran - Sing
Carly Rae Jepsen - Call Me Maybe
Vengaboys - We’re Going to Ibiza!
Snow Patrol - Just Say Yes
Iggy Azalea - Fancy
Pato Banton - Baby Come Back
Weezer - Buddy Holly
Rene Schuurmans - Laat De Zon In Je Hart
Kelis - Milkshake
Baccara - Yes Sir, I Can Boogie
Barry White - Never, Never Gonna Give Ya Up
Ultimate Kaos - Casanova
Shaggy - Mr Boombastic
SEREBRO - Mimimi
LunchMoney Lewis - Bills
Justin Timberlake - SexyBack (feat. Timbaland)
PSY - Gangnam Style (강남스타일)
Günther - Ding Dong Song - Radio Edit
André Hazes Jr. - Leef
Barbarella - We Cheer You Up
The Turtles - Happy Together
Rammstein - Du hast
Yazz - The Only Way Is Up
Calvin Harris - Feels (feat. Pharrell Williams, Katy Perry & Big Sean)
Whigfield - Saturday Night - Radio Mix
AC/DC - Thunderstruck
Galantis - No Money
Zangeres Zonder Naam - Mexico
Loona - Vamos a la Playa - Radio Edit
Five - If Ya Gettin' Down
The Temptations - My Girl
Mariah Carey - Honey
Dune - Are You Ready To Fly - Radio Mix
Shakira - Whenever, Wherever
The Opposites - Broodje Bakpao
K-Liber - Viben
Army Of Lovers - Crucified
Gordon - Kon Ik Maar Even Bij Je Zijn
Manau - La tribu de Dana
Solid HarmoniE - I Want You to Want Me
Andre Hazes - Het Laatste Rondje
MC Hammer - U Can't Touch This
Laserkraft 3D - Nein, Mann!
Paco Paco - Taka Takata
Spice Girls - Wannabe
Sean Paul - Get Busy
The KLF - Justified & Ancient
Ike & Tina Turner - Nutbush City Limits
Patricia Paay - Who's That Lady With My Man
Nielson - Hoe
Corry en de Rekels - Huilen Is Voor Jou Te Laat
T-Spoon - Sex on the Beach - Radio Mix
Cascada - Evacuate The Dancefloor - Radio Edit
Bananarama - Venus
Jamai - Step Right Up
Miami Sound Machine - Conga!
LMFAO - Sexy And I Know It
Cutting Crew - (I Just) Died In Your Arms
De Electronica's - Vogeltjesdans
Bloodhound Gang - The Bad Touch
Arne Jansen - Meisjes Met Rode Haren
Charly Lownoise & Mental Theo - Wonderfull Days - Radio Edit
The Shock Band - Ai Se Eu Te Pego Nosa Nosa
Mel & Kim - Respectable
Michael Gray - The Weekend - Radio Edit
Lesley Gore - It's My Party
Katy Perry - I Kissed A Girl
Mart Hoogkamer - Ik Ga Zwemmen
The 5th Dimension - Aquarius/Let The Sunshine In (The Flesh Failures) - From the Musical "Hair"
Frans Bauer - Heb Je Even Voor Mij
De La Soul - Ring Ring Ring
The Darkness - I Believe in a Thing Called Love
Depeche Mode - Enjoy the Silence
Meghan Trainor - Made You Look
Kungs - Never Going Home
People's Choice - Do It Any Way You Wanna
Paradisio - Bailando
MEROL - LEKKER MET DE MEIDEN
Midnight Oil - Beds Are Burning - Remastered
INNA - Hot
Luv' - You're The Greatest Lover
Manfred Mann - Do Wah Diddy Diddy - 2007 Remaster
Mr. President - Coco Jamboo - Radio Version
Panjabi MC - Mundian to Bach Ke
Infernal - From Paris to Berlin
Koos Alberts - Zijn Het Je Ogen
Kid Rock - All Summer Long
Bob Sinclar - Love Generation
OBZ - Ik Ben Kachel
Roger Glover - Love Is All
Hot Chocolate - You Sexy Thing
La Roux - Bulletproof
Beastie Boys - Fight For Your Right
Barbra Streisand - Woman In Love
Bee Gees - Stayin Alive
Dead Or Alive - You Spin Me Round (Like a Record)
Olivia Newton-John - Physical - Remastered 2021
BLØF - Alles Is Liefde
The Isley Brothers - Twist And Shout
Tenpole Tudor - Wünderbar
Maywood - Rio
The Nolans - I'm in the Mood for Dancing
FLEMMING - Automatisch
Bizzey - JA!
Donna Summer - Hot Stuff
One Direction - One Way or Another (Teenage Kicks)
Irene Cara - Flashdance...What a Feeling - Radio Edit
Damaru - Mi Rowsu (Tuintje In Mijn Hart)
Scatman John - Scatman (ski-ba-bop-ba-dop-bop)
Culture Club - Karma Chameleon
Donnie - Frans Duits
Kav Verhouzer - Wereldbol
Stefan en Sean - Frikandel Speciaal
Crystal Fighters - Plage
The Opposites - Hey DJ
Samantha - Eviva Espana
Nick & Simon - Rosanne
Village People - YMCA - Original Version 1978
The Weather Girls - It's Raining Men
Enrique Iglesias - Not In Love
Harold Faltermeyer - Axel F
Raffa Fl - Ritmo
Gerard Cox - Die Goeie Ouwe Tijd
The Beach Boys - Good Vibrations - Remastered 2001
Drukwerk - Je Loog Tegen Mij
Henk Wijngaard - Met De Vlam In De Pijp
Spargo - You And Me
ABBA - Money, Money, Money
Icona Pop - I Love It (feat. Charli XCX)